关键词,地区,日期,全部,PC端,移动端
沪深300指数,全国,2023/8/8,1611,481,1130
沪深300指数,全国,2023/8/9,1567,447,1120
沪深300指数,全国,2023/8/10,1556,419,1137
沪深300指数,全国,2023/8/11,1783,509,1274
沪深300指数,全国,2023/8/12,478,144,334
沪深300指数,全国,2023/8/13,446,139,307
沪深300指数,全国,2023/8/14,2093,724,1369
沪深300指数,全国,2023/8/15,1810,475,1335
沪深300指数,全国,2023/8/16,1802,482,1320
沪深300指数,全国,2023/8/17,1857,488,1369
沪深300指数,全国,2023/8/18,1741,473,1268
沪深300指数,全国,2023/8/19,456,123,333
沪深300指数,全国,2023/8/20,516,137,379
沪深300指数,全国,2023/8/21,2039,620,1419
沪深300指数,全国,2023/8/22,2224,633,1591
沪深300指数,全国,2023/8/23,2279,681,1598
沪深300指数,全国,2023/8/24,2043,504,1539
沪深300指数,全国,2023/8/25,2437,814,1623
沪深300指数,全国,2023/8/26,920,182,738
沪深300指数,全国,2023/8/27,833,152,681
沪深300指数,全国,2023/8/28,3303,857,2446
沪深300指数,全国,2023/8/29,2403,647,1756
沪深300指数,全国,2023/8/30,2116,430,1686
沪深300指数,全国,2023/8/31,1656,338,1318
沪深300指数,全国,2023/9/1,1545,316,1229
沪深300指数,全国,2023/9/2,483,114,369
沪深300指数,全国,2023/9/3,385,87,298
沪深300指数,全国,2023/9/4,1856,377,1479
沪深300指数,全国,2023/9/5,1635,319,1316
沪深300指数,全国,2023/9/6,1558,310,1248
沪深300指数,全国,2023/9/7,1600,408,1192
沪深300指数,全国,2023/9/8,1788,540,1248
沪深300指数,全国,2023/9/9,531,162,369
沪深300指数,全国,2023/9/10,545,159,386
沪深300指数,全国,2023/9/11,1991,586,1405
沪深300指数,全国,2023/9/12,1741,475,1266
沪深300指数,全国,2023/9/13,1650,476,1174
沪深300指数,全国,2023/9/14,1612,451,1161
沪深300指数,全国,2023/9/15,1812,532,1280
沪深300指数,全国,2023/9/16,460,137,323
沪深300指数,全国,2023/9/17,443,135,308
沪深300指数,全国,2023/9/18,1776,552,1224
沪深300指数,全国,2023/9/19,1738,551,1187
沪深300指数,全国,2023/9/20,1600,481,1119
沪深300指数,全国,2023/9/21,1762,535,1227
沪深300指数,全国,2023/9/22,1899,566,1333
沪深300指数,全国,2023/9/23,458,118,340
沪深300指数,全国,2023/9/24,411,127,284
沪深300指数,全国,2023/9/25,1661,533,1128
沪深300指数,全国,2023/9/26,1517,402,1115
沪深300指数,全国,2023/9/27,1537,350,1187
沪深300指数,全国,2023/9/28,1602,408,1194
沪深300指数,全国,2023/9/29,385,101,284
沪深300指数,全国,2023/9/30,327,95,232
沪深300指数,全国,2023/10/1,332,112,220
沪深300指数,全国,2023/10/2,316,95,221
沪深300指数,全国,2023/10/3,321,83,238
沪深300指数,全国,2023/10/4,318,97,221
沪深300指数,全国,2023/10/5,334,116,218
沪深300指数,全国,2023/10/6,364,114,250
沪深300指数,全国,2023/10/7,701,184,517
沪深300指数,全国,2023/10/8,582,173,409
沪深300指数,全国,2023/10/9,1808,564,1244
沪深300指数,全国,2023/10/10,1612,453,1159
沪深300指数,全国,2023/10/11,1740,515,1225
沪深300指数,全国,2023/10/12,1894,616,1278
沪深300指数,全国,2023/10/13,1733,487,1246
沪深300指数,全国,2023/10/14,450,135,315
沪深300指数,全国,2023/10/15,366,123,243
沪深300指数,全国,2023/10/16,1785,591,1194
沪深300指数,全国,2023/10/17,1673,513,1160
沪深300指数,全国,2023/10/18,1756,592,1164
沪深300指数,全国,2023/10/19,2319,785,1534
沪深300指数,全国,2023/10/20,2385,855,1530
沪深300指数,全国,2023/10/21,569,155,414
沪深300指数,全国,2023/10/22,531,201,330
沪深300指数,全国,2023/10/23,2490,877,1613
沪深300指数,全国,2023/10/24,2587,836,1751
沪深300指数,全国,2023/10/25,2151,668,1483
沪深300指数,全国,2023/10/26,2012,628,1384
沪深300指数,全国,2023/10/27,2174,701,1473
沪深300指数,全国,2023/10/28,547,142,405
沪深300指数,全国,2023/10/29,468,155,313
沪深300指数,全国,2023/10/30,2001,630,1371
沪深300指数,全国,2023/10/31,1868,592,1276
沪深300指数,全国,2023/11/1,1935,557,1378
沪深300指数,全国,2023/11/2,1728,575,1153
沪深300指数,全国,2023/11/3,1710,473,1237
沪深300指数,全国,2023/11/4,405,137,268
沪深300指数,全国,2023/11/5,400,155,245
沪深300指数,全国,2023/11/6,2097,754,1343
沪深300指数,全国,2023/11/7,1806,551,1255
沪深300指数,全国,2023/11/8,1763,566,1197
沪深300指数,全国,2023/11/9,1678,504,1174
沪深300指数,全国,2023/11/10,1565,478,1087
沪深300指数,全国,2023/11/11,453,139,314
沪深300指数,全国,2023/11/12,357,142,215
沪深300指数,全国,2023/11/13,1474,443,1031
沪深300指数,全国,2023/11/14,1756,591,1165
沪深300指数,全国,2023/11/15,1970,732,1238
沪深300指数,全国,2023/11/16,1644,546,1098
沪深300指数,全国,2023/11/17,1581,468,1113
沪深300指数,全国,2023/11/18,438,137,301
沪深300指数,全国,2023/11/19,446,144,302
沪深300指数,全国,2023/11/20,1724,516,1208
沪深300指数,全国,2023/11/21,1879,591,1288
沪深300指数,全国,2023/11/22,1594,488,1106
沪深300指数,全国,2023/11/23,1591,405,1186
沪深300指数,全国,2023/11/24,1601,490,1111
沪深300指数,全国,2023/11/25,550,139,411
沪深300指数,全国,2023/11/26,466,151,315
沪深300指数,全国,2023/11/27,1574,454,1120
沪深300指数,全国,2023/11/28,1503,448,1055
沪深300指数,全国,2023/11/29,1617,495,1122
沪深300指数,全国,2023/11/30,1509,409,1100
沪深300指数,全国,2023/12/1,1600,443,1157
沪深300指数,全国,2023/12/2,444,125,319
沪深300指数,全国,2023/12/3,483,168,315
沪深300指数,全国,2023/12/4,1673,546,1127
沪深300指数,全国,2023/12/5,2131,749,1382
沪深300指数,全国,2023/12/6,2166,644,1522
沪深300指数,全国,2023/12/7,1996,627,1369
沪深300指数,全国,2023/12/8,1692,448,1244
沪深300指数,全国,2023/12/9,466,135,331
沪深300指数,全国,2023/12/10,458,151,307
沪深300指数,全国,2023/12/11,1974,670,1304
沪深300指数,全国,2023/12/12,1684,619,1065
沪深300指数,全国,2023/12/13,1672,540,1132
沪深300指数,全国,2023/12/14,1759,488,1271
沪深300指数,全国,2023/12/15,1965,605,1360
沪深300指数,全国,2023/12/16,513,152,361
沪深300指数,全国,2023/12/17,424,165,259
沪深300指数,全国,2023/12/18,1953,627,1326
沪深300指数,全国,2023/12/19,1864,656,1208
沪深300指数,全国,2023/12/20,1993,623,1370
沪深300指数,全国,2023/12/21,2429,865,1564
沪深300指数,全国,2023/12/22,1951,582,1369
沪深300指数,全国,2023/12/23,554,146,408
沪深300指数,全国,2023/12/24,458,131,327
沪深300指数,全国,2023/12/25,1649,416,1233
沪深300指数,全国,2023/12/26,2026,640,1386
沪深300指数,全国,2023/12/27,1798,487,1311
沪深300指数,全国,2023/12/28,2364,718,1646
沪深300指数,全国,2023/12/29,2121,532,1589
沪深300指数,全国,2023/12/30,570,155,415
沪深300指数,全国,2023/12/31,425,133,292
沪深300指数,全国,2024/1/1,450,166,284
沪深300指数,全国,2024/1/2,1777,533,1244
沪深300指数,全国,2024/1/3,1747,459,1288
沪深300指数,全国,2024/1/4,1903,591,1312
沪深300指数,全国,2024/1/5,1861,535,1326
沪深300指数,全国,2024/1/6,610,180,430
沪深300指数,全国,2024/1/7,505,168,337
沪深300指数,全国,2024/1/8,2368,777,1591
沪深300指数,全国,2024/1/9,2243,699,1544
沪深300指数,全国,2024/1/10,2264,684,1580
沪深300指数,全国,2024/1/11,2038,623,1415
沪深300指数,全国,2024/1/12,1860,547,1313
沪深300指数,全国,2024/1/13,554,146,408
沪深300指数,全国,2024/1/14,479,139,340
沪深300指数,全国,2024/1/15,1985,639,1346
沪深300指数,全国,2024/1/16,2053,673,1380
沪深300指数,全国,2024/1/17,2490,810,1680
沪深300指数,全国,2024/1/18,3509,907,2602
沪深300指数,全国,2024/1/19,2786,870,1916
沪深300指数,全国,2024/1/20,699,177,522
沪深300指数,全国,2024/1/21,587,158,429
沪深300指数,全国,2024/1/22,2912,917,1995
沪深300指数,全国,2024/1/23,2748,857,1891
沪深300指数,全国,2024/1/24,2868,856,2012
沪深300指数,全国,2024/1/25,2861,853,2008
沪深300指数,全国,2024/1/26,2293,560,1733
沪深300指数,全国,2024/1/27,671,131,540
沪深300指数,全国,2024/1/28,441,110,331
沪深300指数,全国,2024/1/29,2139,608,1531
沪深300指数,全国,2024/1/30,2433,789,1644
沪深300指数,全国,2024/1/31,2676,847,1829
沪深300指数,全国,2024/2/1,2635,868,1767
沪深300指数,全国,2024/2/2,2976,862,2114
沪深300指数,全国,2024/2/3,1022,182,840
沪深300指数,全国,2024/2/4,925,287,638
沪深300指数,全国,2024/2/5,3541,916,2625
沪深300指数,全国,2024/2/6,3208,866,2342
沪深300指数,全国,2024/2/7,2926,600,2326
沪深300指数,全国,2024/2/8,2507,349,2158
沪深300指数,全国,2024/2/9,620,85,535
沪深300指数,全国,2024/2/10,298,83,215
沪深300指数,全国,2024/2/11,264,85,179
沪深300指数,全国,2024/2/12,299,102,197
沪深300指数,全国,2024/2/13,263,74,189
沪深300指数,全国,2024/2/14,239,80,159
沪深300指数,全国,2024/2/15,294,101,193
沪深300指数,全国,2024/2/16,297,114,183
沪深300指数,全国,2024/2/17,307,89,218
沪深300指数,全国,2024/2/18,694,215,479
沪深300指数,全国,2024/2/19,2749,847,1902
沪深300指数,全国,2024/2/20,2561,659,1902
沪深300指数,全国,2024/2/21,2677,768,1909
沪深300指数,全国,2024/2/22,2449,701,1748
沪深300指数,全国,2024/2/23,2433,734,1699
沪深300指数,全国,2024/2/24,456,118,338
沪深300指数,全国,2024/2/25,368,127,241
沪深300指数,全国,2024/2/26,2029,695,1334
沪深300指数,全国,2024/2/27,1975,513,1462
沪深300指数,全国,2024/2/28,2280,712,1568
沪深300指数,全国,2024/2/29,2061,588,1473
沪深300指数,全国,2024/3/1,2041,501,1540
沪深300指数,全国,2024/3/2,385,118,267
沪深300指数,全国,2024/3/3,338,155,183
沪深300指数,全国,2024/3/4,2111,751,1360
沪深300指数,全国,2024/3/5,2205,675,1530
沪深300指数,全国,2024/3/6,1952,509,1443
沪深300指数,全国,2024/3/7,1854,473,1381
沪深300指数,全国,2024/3/8,1908,535,1373
沪深300指数,全国,2024/3/9,380,127,253
沪深300指数,全国,2024/3/10,351,133,218
沪深300指数,全国,2024/3/11,1913,468,1445
沪深300指数,全国,2024/3/12,1972,588,1384
沪深300指数,全国,2024/3/13,1790,473,1317
沪深300指数,全国,2024/3/14,1719,498,1221
沪深300指数,全国,2024/3/15,1615,372,1243
沪深300指数,全国,2024/3/16,352,114,238
沪深300指数,全国,2024/3/17,297,108,189
沪深300指数,全国,2024/3/18,1696,492,1204
沪深300指数,全国,2024/3/19,1603,395,1208
沪深300指数,全国,2024/3/20,1524,394,1130
沪深300指数,全国,2024/3/21,1542,381,1161
沪深300指数,全国,2024/3/22,1465,369,1096
沪深300指数,全国,2024/3/23,350,125,225
沪深300指数,全国,2024/3/24,283,118,165
沪深300指数,全国,2024/3/25,1460,371,1089
沪深300指数,全国,2024/3/26,1492,326,1166
沪深300指数,全国,2024/3/27,1528,360,1168
沪深300指数,全国,2024/3/28,1569,423,1146
沪深300指数,全国,2024/3/29,1447,399,1048
沪深300指数,全国,2024/3/30,324,106,218
沪深300指数,全国,2024/3/31,292,118,174
沪深300指数,全国,2024/4/1,1598,411,1187
沪深300指数,全国,2024/4/2,1404,360,1044
沪深300指数,全国,2024/4/3,1319,324,995
沪深300指数,全国,2024/4/4,349,74,275
沪深300指数,全国,2024/4/5,278,99,179
沪深300指数,全国,2024/4/6,244,95,149
沪深300指数,全国,2024/4/7,569,190,379
沪深300指数,全国,2024/4/8,1795,412,1383
沪深300指数,全国,2024/4/9,1484,336,1148
沪深300指数,全国,2024/4/10,1371,315,1056
沪深300指数,全国,2024/4/11,1332,335,997
沪深300指数,全国,2024/4/12,1249,240,1009
沪深300指数,全国,2024/4/13,336,97,239
沪深300指数,全国,2024/4/14,313,140,173
沪深300指数,全国,2024/4/15,1640,416,1224
沪深300指数,全国,2024/4/16,1514,309,1205
沪深300指数,全国,2024/4/17,1576,347,1229
沪深300指数,全国,2024/4/18,1573,380,1193
沪深300指数,全国,2024/4/19,1360,324,1036
沪深300指数,全国,2024/4/20,318,110,208
沪深300指数,全国,2024/4/21,280,93,187
沪深300指数,全国,2024/4/22,1351,360,991
沪深300指数,全国,2024/4/23,1335,343,992
沪深300指数,全国,2024/4/24,1315,321,994
沪深300指数,全国,2024/4/25,1273,282,991
沪深300指数,全国,2024/4/26,1323,321,1002
沪深300指数,全国,2024/4/27,324,99,225
沪深300指数,全国,2024/4/28,483,170,313
沪深300指数,全国,2024/4/29,1438,358,1080
沪深300指数,全国,2024/4/30,1326,313,1013
沪深300指数,全国,2024/5/1,277,93,184
沪深300指数,全国,2024/5/2,277,97,180
沪深300指数,全国,2024/5/3,273,78,195
沪深300指数,全国,2024/5/4,269,87,182
沪深300指数,全国,2024/5/5,307,133,174
沪深300指数,全国,2024/5/6,1504,366,1138
沪深300指数,全国,2024/5/7,1646,436,1210
沪深300指数,全国,2024/5/8,1298,324,974
沪深300指数,全国,2024/5/9,1542,416,1126
沪深300指数,全国,2024/5/10,1541,380,1161
沪深300指数,全国,2024/5/11,559,169,390
沪深300指数,全国,2024/5/12,292,108,184
沪深300指数,全国,2024/5/13,1522,367,1155
沪深300指数,全国,2024/5/14,1307,273,1034
沪深300指数,全国,2024/5/15,1324,304,1020
沪深300指数,全国,2024/5/16,1594,498,1096
沪深300指数,全国,2024/5/17,1517,456,1061
沪深300指数,全国,2024/5/18,343,114,229
沪深300指数,全国,2024/5/19,275,116,159
沪深300指数,全国,2024/5/20,1790,586,1204
沪深300指数,全国,2024/5/21,1579,473,1106
沪深300指数,全国,2024/5/22,1539,437,1102
沪深300指数,全国,2024/5/23,1341,341,1000
沪深300指数,全国,2024/5/24,1489,475,1014
沪深300指数,全国,2024/5/25,327,118,209
沪深300指数,全国,2024/5/26,254,97,157
沪深300指数,全国,2024/5/27,1463,467,996
沪深300指数,全国,2024/5/28,1497,518,979
沪深300指数,全国,2024/5/29,1270,304,966
沪深300指数,全国,2024/5/30,1321,357,964
沪深300指数,全国,2024/5/31,1244,260,984
沪深300指数,全国,2024/6/1,338,137,201
沪深300指数,全国,2024/6/2,274,106,168
沪深300指数,全国,2024/6/3,1391,417,974
沪深300指数,全国,2024/6/4,1335,360,975
沪深300指数,全国,2024/6/5,1313,330,983
沪深300指数,全国,2024/6/6,1408,422,986
沪深300指数,全国,2024/6/7,1239,250,989
沪深300指数,全国,2024/6/8,288,82,206
沪深300指数,全国,2024/6/9,239,87,152
沪深300指数,全国,2024/6/10,271,78,193
沪深300指数,全国,2024/6/11,1335,354,981
沪深300指数,全国,2024/6/12,1373,392,981
沪深300指数,全国,2024/6/13,1303,350,953
沪深300指数,全国,2024/6/14,1378,426,952
沪深300指数,全国,2024/6/15,291,93,198
沪深300指数,全国,2024/6/16,265,104,161
沪深300指数,全国,2024/6/17,1256,299,957
沪深300指数,全国,2024/6/18,1258,316,942
沪深300指数,全国,2024/6/19,1215,271,944
沪深300指数,全国,2024/6/20,1322,374,948
沪深300指数,全国,2024/6/21,1441,467,974
沪深300指数,全国,2024/6/22,339,120,219
沪深300指数,全国,2024/6/23,269,93,176
沪深300指数,全国,2024/6/24,1484,431,1053
沪深300指数,全国,2024/6/25,1360,405,955
沪深300指数,全国,2024/6/26,1352,383,969
沪深300指数,全国,2024/6/27,1236,271,965
沪深300指数,全国,2024/6/28,1346,380,966
沪深300指数,全国,2024/6/29,287,91,196
沪深300指数,全国,2024/6/30,233,78,155
沪深300指数,全国,2024/7/1,1326,361,965
沪深300指数,全国,2024/7/2,1226,270,956
沪深300指数,全国,2024/7/3,1198,268,930
沪深300指数,全国,2024/7/4,1210,253,957
沪深300指数,全国,2024/7/5,1321,366,955
沪深300指数,全国,2024/7/6,296,99,197
沪深300指数,全国,2024/7/7,265,95,170
沪深300指数,全国,2024/7/8,1319,358,961
沪深300指数,全国,2024/7/9,1346,372,974
沪深300指数,全国,2024/7/10,1228,281,947
沪深300指数,全国,2024/7/11,1302,327,975
沪深300指数,全国,2024/7/12,1316,338,978
沪深300指数,全国,2024/7/13,261,82,179
沪深300指数,全国,2024/7/14,233,99,134
沪深300指数,全国,2024/7/15,1205,247,958
沪深300指数,全国,2024/7/16,1279,326,953
沪深300指数,全国,2024/7/17,1315,354,961
沪深300指数,全国,2024/7/18,1261,305,956
沪深300指数,全国,2024/7/19,1285,316,969
沪深300指数,全国,2024/7/20,312,80,232
沪深300指数,全国,2024/7/21,263,85,178
沪深300指数,全国,2024/7/22,1335,381,954
沪深300指数,全国,2024/7/23,1345,388,957
沪深300指数,全国,2024/7/24,1389,397,992
沪深300指数,全国,2024/7/25,1388,394,994
沪深300指数,全国,2024/7/26,1299,327,972
沪深300指数,全国,2024/7/27,293,91,202
沪深300指数,全国,2024/7/28,236,95,141
沪深300指数,全国,2024/7/29,1246,296,950
沪深300指数,全国,2024/7/30,1285,332,953
沪深300指数,全国,2024/7/31,1328,340,988
沪深300指数,全国,2024/8/1,1233,281,952
沪深300指数,全国,2024/8/2,1195,273,922
沪深300指数,全国,2024/8/3,246,76,170
沪深300指数,全国,2024/8/4,224,85,139
沪深300指数,全国,2024/8/5,1338,354,984
沪深300指数,全国,2024/8/6,1362,378,984
沪深300指数,全国,2024/8/7,1241,290,951
沪深300指数,全国,2024/8/8,1291,355,936
沪深300指数,全国,2024/8/9,1253,315,938
沪深300指数,全国,2024/8/10,259,82,177
沪深300指数,全国,2024/8/11,214,82,132
沪深300指数,全国,2024/8/12,1205,265,940
沪深300指数,全国,2024/8/13,1224,290,934
沪深300指数,全国,2024/8/14,1202,279,923
沪深300指数,全国,2024/8/15,1214,279,935
沪深300指数,全国,2024/8/16,1208,279,929
沪深300指数,全国,2024/8/17,284,95,189
沪深300指数,全国,2024/8/18,217,66,151
沪深300指数,全国,2024/8/19,1286,377,909
沪深300指数,全国,2024/8/20,1224,309,915
沪深300指数,全国,2024/8/21,1202,274,928
沪深300指数,全国,2024/8/22,1316,357,959
沪深300指数,全国,2024/8/23,1217,267,950
沪深300指数,全国,2024/8/24,280,74,206
沪深300指数,全国,2024/8/25,265,104,161
沪深300指数,全国,2024/8/26,1161,248,913
沪深300指数,全国,2024/8/27,1160,248,912
沪深300指数,全国,2024/8/28,1184,260,924
沪深300指数,全国,2024/8/29,1185,237,948
沪深300指数,全国,2024/8/30,1274,312,962
沪深300指数,全国,2024/8/31,259,76,183
沪深300指数,全国,2024/9/1,248,87,161
沪深300指数,全国,2024/9/2,1228,287,941
沪深300指数,全国,2024/9/3,1260,319,941
沪深300指数,全国,2024/9/4,1202,270,932
沪深300指数,全国,2024/9/5,1171,253,918
沪深300指数,全国,2024/9/6,1194,274,920
沪深300指数,全国,2024/9/7,286,91,195
沪深300指数,全国,2024/9/8,268,101,167
沪深300指数,全国,2024/9/9,1287,335,952
沪深300指数,全国,2024/9/10,1267,310,957
沪深300指数,全国,2024/9/11,1284,344,940
沪深300指数,全国,2024/9/12,1269,340,929
沪深300指数,全国,2024/9/13,1195,267,928
沪深300指数,全国,2024/9/14,395,139,256
沪深300指数,全国,2024/9/15,239,66,173
沪深300指数,全国,2024/9/16,244,83,161
沪深300指数,全国,2024/9/17,231,76,155
沪深300指数,全国,2024/9/18,1310,375,935
沪深300指数,全国,2024/9/19,1566,569,997
沪深300指数,全国,2024/9/20,1272,332,940
沪深300指数,全国,2024/9/21,285,95,190
沪深300指数,全国,2024/9/22,273,93,180
沪深300指数,全国,2024/9/23,1255,333,922
沪深300指数,全国,2024/9/24,1751,575,1176
沪深300指数,全国,2024/9/25,2001,613,1388
沪深300指数,全国,2024/9/26,2277,772,1505
沪深300指数,全国,2024/9/27,3128,884,2244
沪深300指数,全国,2024/9/28,980,215,765
沪深300指数,全国,2024/9/29,1267,412,855
沪深300指数,全国,2024/9/30,4255,1118,3137
沪深300指数,全国,2024/10/1,1079,208,871
沪深300指数,全国,2024/10/2,1109,213,896
沪深300指数,全国,2024/10/3,992,139,853
沪深300指数,全国,2024/10/4,880,158,722
沪深300指数,全国,2024/10/5,795,184,611
沪深300指数,全国,2024/10/6,1050,229,821
沪深300指数,全国,2024/10/7,1579,457,1122
沪深300指数,全国,2024/10/8,7242,1768,5474
沪深300指数,全国,2024/10/9,5068,1461,3607
沪深300指数,全国,2024/10/10,4896,1434,3462
沪深300指数,全国,2024/10/11,3544,974,2570
沪深300指数,全国,2024/10/12,1258,377,881
沪深300指数,全国,2024/10/13,743,152,591
沪深300指数,全国,2024/10/14,3086,935,2151
沪深300指数,全国,2024/10/15,2705,865,1840
沪深300指数,全国,2024/10/16,2607,873,1734
沪深300指数,全国,2024/10/17,2505,844,1661
沪深300指数,全国,2024/10/18,2775,868,1907
沪深300指数,全国,2024/10/19,575,150,425
沪深300指数,全国,2024/10/20,423,125,298
沪深300指数,全国,2024/10/21,2444,777,1667
沪深300指数,全国,2024/10/22,2102,642,1460
沪深300指数,全国,2024/10/23,2179,661,1518
沪深300指数,全国,2024/10/24,1865,499,1366
沪深300指数,全国,2024/10/25,1869,496,1373
沪深300指数,全国,2024/10/26,417,125,292
沪深300指数,全国,2024/10/27,353,121,232
沪深300指数,全国,2024/10/28,1839,509,1330
沪深300指数,全国,2024/10/29,1621,440,1181
沪深300指数,全国,2024/10/30,1459,377,1082
沪深300指数,全国,2024/10/31,1608,453,1155
沪深300指数,全国,2024/11/1,1642,461,1181
沪深300指数,全国,2024/11/2,384,131,253
沪深300指数,全国,2024/11/3,371,133,238
沪深300指数,全国,2024/11/4,1846,541,1305
沪深300指数,全国,2024/11/5,2157,614,1543
沪深300指数,全国,2024/11/6,2296,630,1666
沪深300指数,全国,2024/11/7,2257,603,1654
沪深300指数,全国,2024/11/8,2299,597,1702
沪深300指数,全国,2024/11/9,423,120,303
沪深300指数,全国,2024/11/10,356,110,246
沪深300指数,全国,2024/11/11,2142,645,1497
沪深300指数,全国,2024/11/12,1954,602,1352
沪深300指数,全国,2024/11/13,1846,509,1337
沪深300指数,全国,2024/11/14,1658,440,1218
沪深300指数,全国,2024/11/15,1708,538,1170
沪深300指数,全国,2024/11/16,442,135,307
沪深300指数,全国,2024/11/17,307,108,199
沪深300指数,全国,2024/11/18,1853,592,1261
沪深300指数,全国,2024/11/19,1777,602,1175
沪深300指数,全国,2024/11/20,1615,487,1128
沪深300指数,全国,2024/11/21,1474,454,1020
沪深300指数,全国,2024/11/22,1428,433,995
沪深300指数,全国,2024/11/23,318,106,212
沪深300指数,全国,2024/11/24,289,110,179
沪深300指数,全国,2024/11/25,1431,443,988
沪深300指数,全国,2024/11/26,1380,403,977
沪深300指数,全国,2024/11/27,1459,443,1016
沪深300指数,全国,2024/11/28,1455,468,987
沪深300指数,全国,2024/11/29,1407,409,998
沪深300指数,全国,2024/11/30,414,133,281
沪深300指数,全国,2024/12/1,325,123,202
沪深300指数,全国,2024/12/2,1420,437,983
沪深300指数,全国,2024/12/3,1462,451,1011
沪深300指数,全国,2024/12/4,1310,354,956
沪深300指数,全国,2024/12/5,1245,259,986
沪深300指数,全国,2024/12/6,1306,329,977
沪深300指数,全国,2024/12/7,312,85,227
沪深300指数,全国,2024/12/8,284,101,183
沪深300指数,全国,2024/12/9,1325,341,984
沪深300指数,全国,2024/12/10,1746,592,1154
沪深300指数,全国,2024/12/11,1417,371,1046
沪深300指数,全国,2024/12/12,1449,388,1061
沪深300指数,全国,2024/12/13,1456,433,1023
沪深300指数,全国,2024/12/14,366,123,243
沪深300指数,全国,2024/12/15,283,99,184
沪深300指数,全国,2024/12/16,1363,395,968
沪深300指数,全国,2024/12/17,1454,451,1003
沪深300指数,全国,2024/12/18,1303,344,959
沪深300指数,全国,2024/12/19,1316,352,964
沪深300指数,全国,2024/12/20,1365,425,940
沪深300指数,全国,2024/12/21,289,93,196
沪深300指数,全国,2024/12/22,271,106,165
沪深300指数,全国,2024/12/23,1311,349,962
沪深300指数,全国,2024/12/24,1242,291,951
沪深300指数,全国,2024/12/25,1315,338,977
沪深300指数,全国,2024/12/26,1212,281,931
沪深300指数,全国,2024/12/27,1231,293,938
沪深300指数,全国,2024/12/28,313,101,212
沪深300指数,全国,2024/12/29,281,110,171
沪深300指数,全国,2024/12/30,1225,278,947
沪深300指数,全国,2024/12/31,1306,361,945
沪深300指数,全国,2025/1/1,316,110,206
沪深300指数,全国,2025/1/2,1410,456,954
沪深300指数,全国,2025/1/3,1367,399,968
沪深300指数,全国,2025/1/4,351,116,235
沪深300指数,全国,2025/1/5,323,89,234
沪深300指数,全国,2025/1/6,1374,412,962
沪深300指数,全国,2025/1/7,1294,355,939
沪深300指数,全国,2025/1/8,1330,367,963
沪深300指数,全国,2025/1/9,1223,302,921
沪深300指数,全国,2025/1/10,1189,290,899
沪深300指数,全国,2025/1/11,394,102,292
沪深300指数,全国,2025/1/12,308,93,215
沪深300指数,全国,2025/1/13,1313,383,930
沪深300指数,全国,2025/1/14,1356,408,948
沪深300指数,全国,2025/1/15,1198,298,900
沪深300指数,全国,2025/1/16,1189,287,902
沪深300指数,全国,2025/1/17,1178,278,900
沪深300指数,全国,2025/1/18,301,82,219
沪深300指数,全国,2025/1/19,244,97,147
沪深300指数,全国,2025/1/20,1201,291,910
沪深300指数,全国,2025/1/21,1172,265,907
沪深300指数,全国,2025/1/22,1147,256,891
沪深300指数,全国,2025/1/23,1182,250,932
沪深300指数,全国,2025/1/24,1125,218,907
沪深300指数,全国,2025/1/25,282,83,199
沪深300指数,全国,2025/1/26,321,116,205
沪深300指数,全国,2025/1/27,1052,176,876
沪深300指数,全国,2025/1/28,249,72,177
沪深300指数,全国,2025/1/29,193,68,125
沪深300指数,全国,2025/1/30,191,70,121
沪深300指数,全国,2025/1/31,205,70,135
沪深300指数,全国,2025/2/1,217,83,134
沪深300指数,全国,2025/2/2,199,76,123
沪深300指数,全国,2025/2/3,246,89,157
沪深300指数,全国,2025/2/4,259,89,170
沪深300指数,全国,2025/2/5,1166,291,875
沪深300指数,全国,2025/2/6,1215,315,900
沪深300指数,全国,2025/2/7,1277,347,930
沪深300指数,全国,2025/2/8,446,177,269
沪深300指数,全国,2025/2/9,252,91,161
沪深300指数,全国,2025/2/10,1323,388,935
沪深300指数,全国,2025/2/11,1212,305,907
沪深300指数,全国,2025/2/12,1259,346,913
沪深300指数,全国,2025/2/13,1177,253,924
沪深300指数,全国,2025/2/14,1192,278,914
沪深300指数,全国,2025/2/15,321,106,215
沪深300指数,全国,2025/2/16,268,106,162
沪深300指数,全国,2025/2/17,1422,496,926
沪深300指数,全国,2025/2/18,1291,371,920
沪深300指数,全国,2025/2/19,1279,355,924
沪深300指数,全国,2025/2/20,1242,323,919
沪深300指数,全国,2025/2/21,1380,416,964
沪深300指数,全国,2025/2/22,340,85,255
沪深300指数,全国,2025/2/23,299,106,193
沪深300指数,全国,2025/2/24,1260,323,937
沪深300指数,全国,2025/2/25,1298,377,921
沪深300指数,全国,2025/2/26,1192,257,935
沪深300指数,全国,2025/2/27,1251,327,924
沪深300指数,全国,2025/2/28,1269,363,906
沪深300指数,全国,2025/3/1,305,116,189
沪深300指数,全国,2025/3/2,276,106,170
沪深300指数,全国,2025/3/3,1216,296,920
沪深300指数,全国,2025/3/4,1238,323,915
沪深300指数,全国,2025/3/5,1246,329,917
沪深300指数,全国,2025/3/6,1261,324,937
沪深300指数,全国,2025/3/7,1228,290,938
沪深300指数,全国,2025/3/8,278,93,185
沪深300指数,全国,2025/3/9,253,87,166
沪深300指数,全国,2025/3/10,1164,273,891
沪深300指数,全国,2025/3/11,1214,302,912
沪深300指数,全国,2025/3/12,1166,260,906
沪深300指数,全国,2025/3/13,1159,264,895
沪深300指数,全国,2025/3/14,1375,381,994
沪深300指数,全国,2025/3/15,296,87,209
沪深300指数,全国,2025/3/16,252,82,170
沪深300指数,全国,2025/3/17,1251,326,925
沪深300指数,全国,2025/3/18,1252,324,928
沪深300指数,全国,2025/3/19,1169,265,904
沪深300指数,全国,2025/3/20,1115,231,884
沪深300指数,全国,2025/3/21,1186,304,882
沪深300指数,全国,2025/3/22,253,82,171
沪深300指数,全国,2025/3/23,250,99,151
沪深300指数,全国,2025/3/24,1141,233,908
沪深300指数,全国,2025/3/25,1192,291,901
沪深300指数,全国,2025/3/26,1284,381,903
沪深300指数,全国,2025/3/27,1183,262,921
沪深300指数,全国,2025/3/28,1149,270,879
沪深300指数,全国,2025/3/29,305,116,189
沪深300指数,全国,2025/3/30,252,89,163
沪深300指数,全国,2025/3/31,1143,279,864
沪深300指数,全国,2025/4/1,1127,247,880
沪深300指数,全国,2025/4/2,1087,218,869
沪深300指数,全国,2025/4/3,1141,260,881
沪深300指数,全国,2025/4/4,318,87,231
沪深300指数,全国,2025/4/5,238,78,160
沪深300指数,全国,2025/4/6,241,78,163
沪深300指数,全国,2025/4/7,2407,964,1443
沪深300指数,全国,2025/4/8,1848,572,1276
沪深300指数,全国,2025/4/9,1440,380,1060
沪深300指数,全国,2025/4/10,1403,425,978
沪深300指数,全国,2025/4/11,1311,355,956
沪深300指数,全国,2025/4/12,321,99,222
沪深300指数,全国,2025/4/13,314,125,189
沪深300指数,全国,2025/4/14,1300,388,912
沪深300指数,全国,2025/4/15,1180,270,910
沪深300指数,全国,2025/4/16,1227,310,917
沪深300指数,全国,2025/4/17,1211,304,907
沪深300指数,全国,2025/4/18,1183,267,916
